NO texture/north_texture.xpm
SO texture/south_texture.xpm
EA texture/east_texture.xpm
WE texture/west_texture.xpm

C 255,0,0
F 0,100,255

111111111111111
100000000000101
100101000010101
1D1110000010101
1000N0000010101
100000001111101
100000000010001
1000000000D0001
111111D11D11101
100000000000001
111111111111111