WE texture/north_texture.xpm
NO texture/west_texture.xpm
EA texture/east_texture.xpm
SO texture/south_texture.xpm

C 255,0,0,
F 0,100,255

111111111111111
100000000000101
100101000010101
101110000010101
1000N0000010101
100000001111101
100000000000001
100000000000001
111111000111101
100000000000001
111111111111111