NO texture/north_texture.xpm
SO texture/south_texture.xpm
WE texture/west_texture.xpm
EA texture/east_texture.xpm


F 0,100,255
C 255,0,0

11111111111111111111111
10000000000000000000001
10000000000000000000001
10000000000000000000001
10000000000000000000001
10000000000000000000001
10000000000000000000001
10000000000000000000001
1111111111D111111111111
10000010000000000000101
100000D0000000000000D01
10000010000000000000101
10000010000000000000101
111111111D11111111D1111
10000000000000000000001
10000000000000000000001
10000000000000000000001
1000N000000000000000001
10000000000000000000001
11111111111111111111111