NO texture/north_texture.xpm
SO texture/south_texture.xpm
WE texture/west_texture.xpm
EA texture/east_texture.xpm


F 0,100,255
C 255,0,0

111
10D1
1N1111
10DDDD11
111111